Ardha chandrasana with Padahastasana: Half moon pose with hands to feet (Bikram yoga)

Ardha chandrasana: Half moon pose variations 

Ardha uttanasana: Standing half forward bend pose

Dandayamana janushirsasana: Standing head to knee pose

Dandayamana dhanurasana: Standing bow pulling pose

Dandayamana ardha chakrasana: Standing backward bend pose

Eka pada rajakapotasana: One-legged king pidgeon pose

Garudasana: Eagle pose

Natarajasana: Lord of the dance pose

Padangusthasana: Big toe pose

Pada hastasana: Hands-to-feet pose

Parivrtta parsvakonasana: Revolved side angle pose

Parivrtta trikonasana: Revolved triangle pose

Parivrtta baddha trikonasana: Revolved bound triangle pose

Parivrtta utkatasana: Twisted chair

Parivrtta uttanasana: Revolved forward fold pose

Parsvottanasana: Intense side stretch pose (Pyramid pose)

Prasarita Padottanasana: Wide-legged forward bend pose

Svarga Dvidasana: Bird of Paradise Pose

Tadasana: Mountain pose

Tuladandasana: Balancing stick pose

Urdhva hastasana: Upward salute

Urdhva prasarita eka padasana: Standing split pose

Utkatasana: Chair pose

Uttanasana: Standing forward bend pose

Utthita Hasta Padangustasana: Extended hand-to-big-toe pose

Utthita Parsvakonasana: Extended side angle pose

Utthita trikonasana: Triangle pose

Virabhadrasana 1: Warrior i

Virabhadrasana 2: Warrior ii

Virabhadrasana 3: Warrior iii

Vrksasana: Tree pose